R 1920 1080

NO ./textures/Nord.xpm
SO  ./textures/Sud.xpm
WE ./textures/West.xpm
EA  ./textures/East.xpm
S  ./textures/diamond.xpm

C 0,0,255
F 255,0,255

   111111111111111111111111111
  110000000000000000001000000111
1100000001000000S0000111000111
10000000000000000021010001111 
111111100001000000010000000111
111111111111111111111111111

