R 1920 1080

NO ./textures/Nord.xpm
SO  ./textures/Sud.xpm
WE ./textures/West.xpm
EA  ./textures/East.xpm
S  ./textures/diamond.xpm

C 0,0,0
F 255,255,255

   111111111111111111111111111
  110000000200000000001000000111
1100000001000000W0000111000111
10000000000200000021010001111 
111111100001000000010000000111
111111111111111111111111111

