1111111111111111111111111111111111111111111111
1111111111111111111111111111111111111111111111
1111111111111111111111111111111111111111111111
1111111111111111111000P00011111111111111111111
1111111111111100C01000000000000001111111111111
1111111111110000000000000000000001111111111111
1111111111100000000000000000000000000111111111
111111110000000000C00000000000C000000111111111
11111000000C0000000000000000000000001111111111
111110000000000000000000C00000C000011111111111
1111110000000000000C00000000000000011111111111
1111111100000000000000000000000000000011111111
1111111101000000000000000000000000000111111111
11111111110000C000000000000000C000000111111111
1111111111100000011111000000000000001111111111
1111111111000001111E000C0000000000011111111111
1111111100000000111111000000000000011011111111
1111111110000000000000000000000011110001111111
111111111100000000000000C000111111100001111111
1111111111111111111111111111111111100000111111
1111111111111111111111111111111111111001111111
1111111111111111111111111111111111111111111111